-.B.-.-.-.-.-.-.S.-
B.P.B.-.-.-.G.S.W.S
-.B.-.-.-.-.-.-.S.-
-.-.-.S.-.-.-.G.-.-
-.-.BS.W.S.-.-.G.-.-
-.B.P.BS.-.-.-.-.-.-
-.A.B.-.-.-.-.B.B.-
-.-.-.S.-.G.B.P.P.B
-.-.S.GW.S.G.-.B.B.-
-.-.-.S.-.-.-.-.-.-
