P.BS.B.P.B.G.G.-.B.P
BS.W.S.B.-.-.G.-.-.B
-.S.G.-.-.-.-.-.-.G
G.G.-.-.-.G.-.-.-.-
-.-.-.G.-.-.-.G.-.-
-.-.-.G.G.-.G.-.-.-
-.G.-.-.G.G.-.G.G.-
-.-.A.-.G.G.G.-.G.-
G.-.-.-.-.-.G.G.-.-
-.-.-.-.G.-.-.-.-.-
