10
-.B.P.B.P.B.B.P.B.G
-.B.B.-.B.-.-.B.-.S
B.P.BS.G.-.-.-.-.S.W
-.BS.W.S.S.-.G.G.G.S
G.G.S.S.W.S.-.G.-.-
-.-.G.-.S.-.-.-.-.-
-.-.-.-.-.A.G.-.-.-
-.-.-.-.-.-.-.G.-.-
-.G.-.-.-.-.-.-.-.-
-.-.-.G.-.-.-.-.G.-
