10
B.-.-.B.G.-.G.G.B.P
P.B.B.P.B.G.-.-.-.BS
B.B.-.B.-.-.G.-.S.W
B.P.B.-.-.G.-.G.-.S
G.BS.-.S.-.-.-.G.-.-
S.W.S.W.S.-.A.G.-.G
-.S.-.S.-.-.-.-.G.-
-.-.-.-.-.-.-.-.-.-
-.G.-.-.-.-.-.G.-.-
-.-.-.G.-.-.-.-.-.-
