10
S.W.S.-.-.S.W.S.G.B
S.S.-.B.-.-.S.-.B.P
W.S.B.P.B.G.-.-.-.B
S.-.-.B.-.G.-.-.B.-
-.-.-.-.-.B.-.B.P.B
-.-.-.-.B.P.B.-.B.-
-.-.G.-.G.B.-.-.-.-
-.G.G.-.-.-.-.G.G.-
G.-.-.-.-.-.-.-.-.-
-.-.-.-.A.-.-.-.G.G
