10
-.S.-.-.-.B.P.B.S.W
S.W.S.-.S.-.B.-.B.S
-.BS.G.S.W.S.-.B.P.B
B.P.B.-.S.-.-.-.B.P
-.B.-.-.-.-.-.-.-.B
-.-.-.-.G.-.G.-.-.-
G.-.-.-.-.-.-.-.-.-
-.-.-.-.G.-.G.-.-.-
-.-.A.-.-.G.-.-.-.G
-.-.-.-.-.-.-.-.-.G
